******************  Labios ************************************

Brillo magico qlanney: resalta la belleza natural de kis kabuis gracias a que nutre e hidrata. 

Tinta de labios ushas: brinda un tono natural, hidrata y suaviza los labios. Se puede usar como rubor porque se puede difuminar fácilmente.

Hidratante de labios fresita Magic: Brinda una acción hidratante y nutritiva consiguiendo unos labios suaves.

Lipgloss: no maltrata ni reseca los labios, es matte y de larga duración.

Labial en barra Romantic bird: no maltrata ni reseca los labios, es matte.

Labial liquid matte velvet: no maltrata ni reseca los labios, es matte.

Brillo magin SFR color: resalta la belleza natural de los labios.

****************** Ojos***********************************

Eyeliner Romantic Bird: Alarga y brinda volumen a las pestañas, es lavable pero no se corre ni se riega.

Cera para cejas: su fórmula logra un acabado natural que permite mantener las cejas peinadas y definidas todo el día.
 
Cejas Ushas: producto cremoso que sirve para darle forma y color a tus cejas.

Sombras: contiene 30 todos de 12 sombras y 12 tonos versatiles que funcionan como rubores, iluminadores y contorno.

Sombras Coco Urban: contiene 40 tonos de sobras y 2 tonos de glitter. Tiene espejo

Sombras corazón ushas: contient 6 colores de sobras distribuidos entre mates y satinados.

Sombras colorvision: contiene 7 tonos glitter y 28 tonos de sombras. Tiene espejo.

Sombras desert dusk: contiene 5 tonos de glitter y 40 tonos de sombras. Tinee espejo.

Sombras choose happy: contiene 30 tonos de glitter y tiene espejo.

Kit de cejas magic Scanlon: contiene 6 sombras, 2 brochas, 1 lápiz, depilador y plantillas de cejas. En tonos universales para cejas de medio a oscuro.

kit de cejas bloom beauty: kit de cejas con 1 betún, 5 sombras, 2 brochas, 1 lápiz y plantillas para cejas. En tonos universales para cejas de medio a oscuro.
Ride to space: contiene 15 colores de sombras distribuidos entre mates y satinados.

******************** Rostro *********************************

Contour: fórmula suave que se difumina perfectamente en la piel.

Ministar: es ligero y fácil de aplicar, es libre de parabenos y fragancias.

Rubor estrella: excelente pigmentación que permite lograr un acabado natural al maquillaje (blush)

Polvo compacto: brinda un acabado matte con una textura suave y ligera.

Ideal stay: fácil de difuminar y deja el rostro liviano y suave. Es de larga duración con cobertura media.

Iluminador y rubor ushas: iluminador con muchos destellos y rubor con acabado matte, crean un efecto muy natural en la piel.

Iluminado Hug me: contiene 2 iluminadores, su alta pigmentación permite conseguir un maquillaje perfecto e iluminado.

Rubor mini SFR: pigmentación excelente y de fácil aplicación que logra un maquillaje natural y hermoso

Base BB cream: producto todo en uno. Hidrata, corrige y unifica el color del rostro. Textura ligera a base de agua.

Corrector liquido Miss Rose: su textura es suave y cubre las imperfecciones, libre de aceite y a prueba de agua.

